111111111111111111111
120000001000000000101
101011101111111010101
101010100010000010101
101010111110111110101
101000000010000010001
101111111010111011101
101000101010001000101
101011101011101111101
100010001000001000101
111110101111111010101
101000100010000010101
101011101110111110101
101010001000100010001
101010111011111011111
100010100010000000101
101110101110111110101
101010100000100000101
101010111111101111101
100010000000000000031
111111111111111111111
