111111111111111111111
120000100000000000001
101110111111111110111
101010000000100010001
101011111110101011101
100010000010101000101
101111101110111011101
100010000010001000101
101010111110101110101
101000001010101000101
101111101010101011101
100000101000100010001
111110101111111110111
100010101000000010001
101111101010111011101
100010100010001000001
101010101111111111101
101000100000100010001
101111111110111010111
100000000000001000031
111111111111111111111
