11111111111111111111111111111111111111111
12000000100010001000100010000010000000001
11111110101110101010101011111011111111101
10000000001000100010101000100010000010001
10111111111011111110101111101110111010111
10000000001010000010101000100010101010001
11111111101011101010101110101010101011101
10000000100010001010101010001010101010001
10101111111110111010101011111010101010111
10100000000010100010001000000010100000001
10111111101110101110111111101110111111101
10000010100010100000100000001000101000101
11101110111010111111101111111011101010101
10000000101000100010000010000010001010001
10111110101111101011111011101010111011111
10001000001000001000100010001010001010001
11101011101011111110111010111111101010111
10001000101000100010000010000010001010001
10111110101110101011111110111010111011101
10100000101000101010000010100010100010001
10101111101011101010101010101110111010111
10101000001000101010101010100010001010001
10101011101010101011101010111011101011101
10101010100010101000001010001000101000001
10111010111111101111111010111011101111111
10100010000010001010000010100010001000001
10111011101110111010111111101010111011101
10001000000000100000100000001000100000101
11101011111111101111101110111111101111101
10101010001000100000100010000000001000001
10101110101110111110111111101111111011111
10100000100010001000100000101010001010001
10111111111011101011101110101010101010101
10001000001010001010101000101000101000101
11101011101010101010101011101111101011111
10001000100010101000101010100000001010001
10111110111110111110101010111111101010101
10100000100010000000101010000000001000101
10101111101011111111101011111111111111101
10000000001000000000001000000000000000031
11111111111111111111111111111111111111111
