11111111111111111111111111111111111111111
12001000000000100000100010000010000000101
10101011111110101010101011101010101110101
10101000100000001010101000101000101000001
10101111101011111011101110101111111011101
10100000001010001000100010001000100010101
11101011111010101110111010111010101110101
10001010001000100010000010000010101000001
10111110101111111011111111111111101110111
10000000101000100010000000100000000010001
11111110111010101110111111101111111111101
10000000000010100010001000100010000000101
10111111111110111010101010111011101011101
10100000000010101010101010001010001010001
10111111111010101011101010101010111111111
10001010000010001000101010100000000000001
11101010111110101110101011111110111111101
10100010000000101000101000101010000010001
10111011101111101111101110101011111010101
10100010001000101000000000001000101010101
10101110111110101111111111111110101010101
10101000100010000000100000000000100010101
10101011101011111110101111111111111010111
10101000101000000010001000100000000010001
10101110101111111011111110101111101110111
10101000100000101000000010000010101000001
10101011111010101111111011111010101111101
10101000001010101000001000100000100010101
10101011101010101011101110111110111110101
10001010101010100010001010001000000000101
10101010101010101110101011101111111111101
10101000100010101010100000101000001000001
10101110111110101010111110101011101011111
10100010001000100010001000101010101000101
10111011101110111111101011101110101010101
10001010100010001000001010001000101010001
11101110111011101011111011111010101011101
10100000100010000010000010001010101000101
10111110101111111110111110101110101111101
10000000100000000010000000100000100000031
11111111111111111111111111111111111111111
